Acheron|(Greek mythology) a river in Hades across which the souls of the dead were carried by Charon
Aconcagua|the highest mountain in the western hemisphere; located in the Andes in western Argentina (22,834 feet high)
Adams|a mountain peak in southwestern Washington in the Cascade Range (12,307 feet high)
Adam's Peak|a mountain peak in south central Sri Lanka (7,360 feet high)
Adige|a river in northern Italy that flows southeast into the Adriatic Sea; "Verona is on the Adige"
Adirondacks|a mountain range in northeastern New York State; a popular resort area
Admiralty Range|mountains in Antarctica to the north of Victoria Land
Adriatic|an arm of the Mediterranean between Slovenia and Croatia and Montenegro and Albania on the east and Italy on the west
Aegean|an arm of the Mediterranean between Greece and Turkey; a main trade route for the ancient civilizations of Crete and Greece and Rome and Persia
Aegospotami|a creek emptying into the Hellespont in present-day Turkey; at its mouth in 405 BC the Spartan fleet under Lysander defeated the Athenians and ended the Peloponnesian War
Africa|the second largest continent; located to the south of Europe and bordered to the west by the South Atlantic and to the east by the Indian Ocean
Aire|a river in northern England that flows southeast through West Yorkshire
Alabama|a river in Alabama formed by the confluence of the Coosa and Tallapoosa Rivers near Montgomery; flows southwestward to become a tributary of the Mobile River
Alaska Peninsula|a peninsula of southwestern Alaska (a continuation of the Aleutian Islands)
Alaska Range|a mountain range in south central Alaska; contains Mount McKinley
Aldebaran|the brightest star in Taurus
Algol|the second brightest star in Perseus; the first known eclipsing binary
Alleghenies|the western part of the Appalachian Mountains; extending from northern Pennsylvania to southwestern Virginia
Allegheny|a river that rises in Pennsylvania and flows north into New York and then back south through Pennsylvania again to join the Monongahela River at Pittsburgh which is the beginning of the Ohio River
Alpha Centauri|brightest star in Centaurus; second nearest star to the sun
Alpha Crucis|the brightest star in the Southern Cross
Alpine glacier|a glacier that moves down from a high valley
Alps|a large mountain system in south-central Europe; scenic beauty and winter sports make them a popular tourist attraction
Altai Mountains|a mountain range in central Asia that extends a thousand miles from Kazakhstan eastward into western Mongolia and northern China
Altair|double star 15.7 light years from Earth; the brightest star in the Aquila constellation
Amazon|a major South American river; arises in the Andes and flows eastward into the South Atlantic; the world's 2nd longest river (4000 miles)
America|North America and South America and Central America
American Falls|a part of Niagara Falls in western New York (north of Buffalo)
Amur|an Asian river between China and Russia; flows into the Sea of Okhotsk
Ancohuma|a mountain peak in the Andes in Bolivia (20,960 feet high)
Andaman Sea|part of the Bay of Bengal to the west of the Malay Peninsula
Andes|a mountain range in South America running 5000 miles along the Pacific coast
Andromeda|a constellation in the northern hemisphere between Cassiopeia and Pegasus; contains the Andromeda galaxy
Angara|a river in southeastern Siberia that flows northwest from Lake Baikal to become a tributary of the Yenisei River
Angel|the highest waterfall; has more than one leap; flow varies seasonally
Annapurna|a mountain in the Himalayas in Nepal (26,500 feet high)
Antarctica|an extremely cold continent at the south pole almost entirely below the Antarctic Circle; covered by an ice cap up to 13,000 feet deep; "Antarctica is twice the size of Australia"
Antarctic Ocean|the southern waters surrounding Antarctica
Antarctic Peninsula|a large peninsula of Antarctica that extends some 1200 miles north toward South America; separates the Weddell Sea from the South Pacific
Antares|the brightest star in Scorpius
Antlia|a faint constellation in the southern hemisphere near Hydra and Vela
Apalachicola|a river in northwestern Florida formed by the confluence of the Chattahoochee River and the Flint River at the Florida border
Apennines|a mountain range extending the length of the Italian peninsula
Apollo asteroid|an asteroid whose orbit crosses the Earth's orbit
Appalachians|a mountain range in the eastern United States extending from Quebec to the Gulf of Mexico; a historic barrier to early westward expansion of the United States
Apus|a constellation in the polar region of the southern hemisphere near Octans
Aquarius|a zodiacal constellation in the southern hemisphere; between Capricornus and Pisces
Aquila|a constellation in the Milky Way near Cygnus; contains the star Altair
Ara|a constellation in the southern hemisphere near Telescopium and Norma
Arabian Sea|a northwestern arm of the Indian Ocean between India and Arabia
Arafura Sea|a part of the western Pacific Ocean to the north of Australia and to the south of New Guinea and the eastern islands of Indonesia
Araguaia|a river in central Brazil that flows generally northward (with many falls) to join the Tocantins River
Ararat|the mountain peak that Noah's ark landed on as the waters of the great flood receded
Aras|a river that rises in northeastern Turkey (near the source of the Euphrates) and flows generally eastward through Armenia to the Caspian Sea; ancient name was Araxes
Arauca|a river that rises in northern Colombia and flows generally eastward to the Orinoco in central Venezuela
Arctic Ocean|ice covered waters surrounding the North Pole; mostly covered with solid ice or with ice floes and icebergs
Arcturus|the 4th brightest star and the brightest star in the constellation Bootes; 36 light-years from Earth
Argo|formerly a large constellation in the southern hemisphere between Canis Major and the Southern Cross; now divided into Carina and Pyxis and Puppis and Vela
Argun|a river in eastern Asia that arises in China and flows northeast along the border between China and Russia to become a tributary of the Amur River
Aries|a small zodiacal constellation in the northern hemisphere; between Pisces and Taurus
Aristarchus|a bright crater on the Moon
Arkansas|a river that rises in the Rocky Mountains in Colorado and flows southeast through Kansas and Oklahoma and through Arkansas to become a tributary of the Mississippi River
Arno|a river in central Italy rising in the Apennines and flowing through Florence and Pisa to the Ligurian Sea
Asia|the largest continent with 60% of the earth's population; it is joined to Europe on the west to form Eurasia; it is the site of some of the world's earliest civilizations
Atacama Trench|a depression in the floor of the Pacific Ocean off the coast of Chile
Atlantic|the 2nd largest ocean; separates North and South America on the west from Europe and Africa on the east
Atlantic Coast|a coast of the Atlantic Ocean
Atlas Mountains|a mountain range in northern Africa between the Mediterranean and the Sahara Desert; extends from southwestern Morocco to northern Tunisia
Auriga|a conspicuous constellation in the northern hemisphere; between Great Bear and Orion at edge of Milky Way
Australia|the smallest continent; between the South Pacific and the Indian Ocean
Australian Alps|a range of mountains in Australia that forms the southern end of the Great Dividing Range
Avon|a river in central England that flows through Stratford-on-Avon and empties into the Severn
Avon|a river in southwestern England rising in Gloucestershire and flowing through Bristol to empty into the estuary of the Severn
Baffin Bay|a body of water between Greenland and northeastern Canada; connected with the Arctic Ocean to the north and with the Atlantic Ocean (via the Labrador Sea) to the south; icebound in winter
Balaton|a large shallow lake in western Hungary
Balkans|the major mountain range of Bulgaria and the Balkan Peninsula
Baltic|a sea in northern Europe; stronghold of the Russian navy
Barents Sea|the part of the Arctic Ocean to the north of Norway and Russia
Bay of Bengal|an arm of the Indian Ocean to the east of India
Bay of Biscay|an arm of the Atlantic Ocean in western Europe; bordered by the west coast of France and the north coast of Spain
Bay of Fundy|a bay of the North Atlantic between New Brunswick and Nova Scotia; noted for rapid tides as great as 70 feet
Bay of Naples|an arm of the Tyrrhenian Sea at Naples
Beaufort Sea|part of the Arctic Ocean to the northeast of Alaska
Bering Sea|part of the North Pacific between Alaska and Siberia; connected to the Arctic Ocean by the Bering Strait
Bering Strait|a strait connecting the Bering Sea to the Arctic Ocean
Berkshires|a low mountain range in western Massachusetts; a resort area
Beta Centauri|the second brightest star in Centaurus
Beta Crucis|the second brightest star in the Southern Cross
Betelgeuse|the second brightest star in Orion
Big Dipper|a group of seven bright stars in the constellation Ursa Major
Bighorn|a river that flows from central Wyoming to the Yellowstone River in southern Montana
Bight of Benin|a broad indentation of the Gulf of Guinea in western Africa
Big Sioux River|a river that rises in northeastern South Dakota and flows southward to join the Missouri River at Sioux City, Iowa
Biscayne Bay|a narrow bay formed by an inlet from the Atlantic Ocean in southeastern Florida
Bismarck Sea|an arm of the South Pacific to the southwest of the Bismarck Archipelago
Black Forest|a hilly forest region in southwestern Germany
Black Hills|mountains in southwestern South Dakota and northeastern Wyoming; sacred to the Sioux (whites settling in the Black Hills led to the Battle of Little Bighorn); site of Mount Rushmore
Black Sea|a sea between Europe and Asia; a popular resort area of eastern Europeans
Blue Nile|a headstream of the Nile; joins the White Nile at Khartoum to form the Nile
Blue Ridge Mountains|a range of the Appalachians extending from southern Pennsylvania to northern Georgia
Bo Hai|an inlet of the Yellow Sea, on the coast of Eastern China
Bonete|a mountain in the Andes in Argentina (22,546 feet high)
Bootes|a constellation in the northern hemisphere near Ursa Major
Bosporus|a strait connecting the Mediterranean and the Black Sea; separates the European and Asian parts of Turkey; an important shipping route
Bougainville Trench|a depression in the floor of the Pacific Ocean between New Guinea and the Solomon Islands
Brahmaputra|an Asian river; flows into the Bay of Bengal
Brazos|a river that rises in Mexico and flows across Texas into the Gulf of Mexico
Brenner Pass|an Alpine mountain pass connecting Innsbruck in Austria with Bolzano in Italy that has long been a route for trade and for invasions
Bristol Channel|an inlet of the Atlantic Ocean between southern Wales and southwestern England
Buzzards Bay|an inlet of the Atlantic Ocean in southeastern Massachusetts
Cachi|a mountain in the Andes in Argentina (22,047 feet high)
Caelum|a constellation in the southern hemisphere near Columba and Eridanus
Callisto|the second largest of Jupiter's satellites
Caloosahatchee|a river in southern Florida that flows westerly to the Gulf of Mexico; forms the western end of the Cross-Florida Waterway
Cam|a river in east central England that flows past Cambridge to join the Ouse River
Cambrian Mountains|a rugged plateau that runs north to south through central Wales
Canadian|a river rising in northeastern New Mexico and flowing eastward across the Texas panhandle to become a tributary of the Arkansas River in Oklahoma
Canadian Falls|a part of Niagara Falls in Ontario
Canandaigua Lake|a glacial lake in central New York; one of the Finger Lakes
Cancer|a small zodiacal constellation in the northern hemisphere; between Leo and Gemini
Canis Major|a constellation to the southeast of Orion; contains Sirius
Canis Minor|a constellation to the east of Orion; contains Procyon
Canopus|supergiant star 650 light years from Earth; second brightest star in the sky
Cantabrian Mountains|a range of mountains in northern Spain along the coast of the Bay of Biscay
Cape Canaveral|a sandy promontory (formerly Cape Kennedy) extending into the Atlantic Ocean from a barrier island off the eastern coast of Florida; the site of a NASA center for spaceflight
Cape Cod Bay|the southern part of Massachusetts Bay
Cape Fear River|a river in North Carolina that flows southeast to the Atlantic Ocean at Cape Fear
Capella|the brightest star in Auriga
Cape Sable|a promontory on the far southern part of Nova Scotia
Cape Sable|a cape at the southwest tip of Florida; the southernmost part of the United States mainland
Cape Trafalgar|a small cape in southwestern Spain; "Nelson defeated the French and Spanish fleets off Cape Trafalgar in 1805"
Cape York|the northern tip of Cape York Peninsula at the Torres Strait; the northernmost point of the Australian mainland
Cape York Peninsula|a peninsula in Queensland in northeastern Australia between the Gulf of Carpentaria and the Coral Sea
Capricornus|a faint zodiacal constellation in the southern hemisphere; between Sagittarius and Aquarius
Caribbean|an arm of the Atlantic Ocean between North and South America; the origin of the Gulf stream
Carina|a keel-shaped constellation in the southern hemisphere; contains the star Canopus
Carlsbad Caverns|a group of caverns in southeastern New Mexico noted for their stalactites and stalagmites
Carpathians|a mountain range in central Europe that extends from Slovakia and southern Poland southeastward through western Ukraine to northeastern Romania; a popular resort area
Cascades|a mountain range in the northwestern United States extending through Washington and Oregon and northern California; a part of the Coast Range
Caspian|a large saltwater lake between Iran and Russia fed by the Volga River; the largest inland body of water in the world
Cassiopeia|a W-shaped constellation in the northern hemisphere near Polaris
Castor|a multiple star with 6 components; second brightest in Gemini; close to Pollux
Cataract Canyon|a tributary of the Grand Canyon
Catskills|a range of the Appalachians to the west of the Hudson in southeastern New York; includes many popular resort areas
Caucasus|the mountain range in Caucasia between the Black Sea and the Caspian Sea that forms part of the traditional border between Europe and Asia
Cayuga Lake|a glacial lake in central New York; the longest of the Finger Lakes
Centaurus|a conspicuous constellation in the southern hemisphere near the Southern Cross
Cepheus|a faint constellation in the northern hemisphere near Cassiopeia and the pole star
Ceres|the largest asteroid and the first discovered
Cetus|a large constellation on the equator near Pisces and Aquarius
Chamaeleon|a faint constellation in the polar region of the southern hemisphere near Apus and Mensa
Changtzu|a mountain in the central Himalayas on the border of Tibet and Nepal (24,780 feet high)
Chao Phraya|a river in Thailand formed by the confluence of the Nan and Ping Rivers; flows southward past Bangkok and empties into the Gulf of Thailand
Charles|a river in eastern Massachusetts that empties into Boston Harbor and that separates Cambridge from Boston
Chattahoochee|a river rising in northern Georgia and flowing southwest and south to join the Flint River at the Florida border where they form the Apalachicola River
Baikal|the largest freshwater lake in Asia or Europe and the deepest lake in the world
Lake Chelan|a narrow very deep lake in central Washington in the Cascade Range
Coeur d'Alene Lake|a lake in northern Idaho
Lake Tahoe|a lake on the border between Nevada and California to the west of Carson City; a popular resort area
Chesapeake Bay|a large inlet of the North Atlantic between Virginia and Maryland; fed by Susquehanna River
Chimborazo|a mountain peak in the Andes in Ecuador (20,560 feet high)
Chiron|an asteroid discovered in 1977; it is unique in having an orbit lying mainly between the orbits of Saturn and Uranus
Chukchi Peninsula|peninsula of northeastern Siberia across the Bering Strait from northwestern Alaska
Chukchi Sea|part of the Arctic Ocean just to the north of the Bering Strait
Cimarron|a river that rises in northeastern New Mexico and flows eastward into Oklahoma where it becomes a tributary of the Arkansas River
Circinus|a small faint constellation in the southern hemisphere near Musca and Triangulum Australe
Clinch River|a river that rises in southwestern Virginia and flows generally southwestward across eastern Tennessee to the Tennessee River
Clyde|a river in western Scotland that flows from the southern uplands into the Firth of Clyde; navigable by oceangoing vessels as far as Glasgow
Coast Range|a string of mountain ranges along the Pacific coast of North America from southeastern Alaska to Lower California
Cocytus|(Greek mythology) a river in Hades that was said to be a tributary of the Acheron
Colorado|an important river in the southwestern United States; rises in the Rocky Mountains of northern Colorado and flows southwest through Utah into Arizona (where it flows through the Grand Canyon) and then southward through the southern tip of Nevada, then forming the border between California and Arizona and finally into Mexico where it empties into the Gulf of California; the main source of water in the southwestern United States
Colorado|a river in Texas; flows southeast into the Gulf of Mexico
Colorado Plateau|a large plateau to the south and west of the Rocky Mountains; abuts mountains on the north and east and ends in an escarpment overlooking lowlands to the south and west; the Grand Canyon is carved out of the southwestern corner
Columba|a constellation in the southern hemisphere near Puppis and Caelum
Columbia|a North American river; rises in southwestern Canada and flows southward across Washington to form the border between Washington and Oregon before emptying into the Pacific; known for its salmon runs in the spring
Coma Berenices|a constellation in the northern hemisphere between Ursa Major and Bootes; contains a cluster of some 10,000 galaxies
Communism Peak|the highest mountain peak in the Pamir Mountains; near the Chinese border in northeastern Tajikistan (24,590 feet high)
Congo|a major African river (one of the world's longest); flows through Congo into the South Atlantic
Connecticut|a river in the northeastern United States; flows south from northern New Hampshire along the border between New Hampshire and Vermont and through Massachusetts and Connecticut where it empties into Long Island Sound
Constance|a lake in southeastern Germany on the northern side of the Swiss Alps; forms part of the Rhine River
Cook Strait|a narrow strait separating the North Island and South Island in New Zealand
Coosa|river that rises in northwestern Georgia and flows southwest through eastern Alabama to join the Tallapoosa River near Montgomery and form the Alabama River
Copernicus|a conspicuous crater on the Moon
Coral Sea|an arm of the South Pacific to the northeast of Australia
Corona Borealis|a small constellation in the northern hemisphere between Bootes and Hercules
Coropuna|a mountain peak in the Andes in Peru (21,083 feet high)
Corvus|a small quadrilateral constellation in the southern hemisphere near Virgo
Crab Nebula|a remnant of a supernova detected first in 1054 AD
Crater|a faint constellation in the southern hemisphere near Hydra and Corvus
Cross-Florida Waterway|a waterway used by small boats to travel between the Atlantic Ocean and the Gulf of Mexico through Lake Okeechobee and the Caloosahatchee Canal and the Caloosahatchee River
Cumberland|a river that rises in southeastern Kentucky and flows westward through northern Tennessee to become a tributary of the Ohio River in southwestern Kentucky
Cumberland Gap|a pass through the Cumberland Mountains between Virginia and Kentucky that early settlers used in order to move west
Cumberland Mountains|the southwestern part of the Appalachians
Cuquenan|a famous waterfall in Venezuela
Cygnus|a constellation in the northern hemisphere between Pegasus and Draco in the Milky Way; contains a black hole
Danube|the 2nd longest European river (after the Volga); flows from southwestern Germany to the Black Sea; "Vienna, Budapest, and Belgrade are on the banks of the Danube"
Darling|an Australian river; tributary of the Murray River
Dead Sea|a saltwater lake on the border between Israel and Jordan; its surface in 1292 feet below sea level
Deimos|the outer of two small satellites of Mars
Delaware|a river that rises in the Catskills in southeastern New York and flows southward along the border of Pennsylvania with New York and New Jersey to northern Delaware where it empties into Delaware Bay
Delaware Bay|an inlet of the North Atlantic; fed by the Delaware River
Delphinus|a constellation in the northern hemisphere near Pegasus and Aquila
Demerara|a river in northern Guyana that flows northward into the Atlantic
Denali Fault|a major open geological fault in Alaska
Deneb|the brightest star in Cygnus
Denebola|a star in Leo approximately 43 light years from Earth
Detroit River|a short river flowing from Lake St. Clair to Lake Erie along the border between the United States and Canada; one the busiest inland waterways in the world
Dhaulagiri|a mountain in the Himalayas in Nepal (26,820 feet high)
Dnieper|a river that rises in Russia near Smolensk and flowing south through Belarus and Ukraine to empty into the Black Sea
Dolomite Alps|an eastern range of the Alps in northeastern Italy famous for their dolomitic limestone
Don|a European river in southwestern Russia; flows into the Sea of Azov
Donner Pass|a mountain pass in northeastern California near Lake Tahoe; site where in 1844 some members of an emigrant party survived by eating those who had died
Dorado|a constellation in the southern hemisphere near Reticulum and Pictor; contains most of the Large Magellanic Cloud
Draco|a faint constellation twisting around the north celestial pole and lying between Ursa Major and Cepheus
Earth|the 3rd planet from the sun; the planet we live on; "the Earth moves around the sun"; "he sailed around the world"
East China Sea|part of the Pacific Ocean near eastern Asia
Ebro|a river in northeastern Spain; flows into the Mediterranean
Elbe|a river in central Europe that arises in northwestern Czechoslovakia and flows northward through Germany to empty into the North Sea
Elizabeth River|a short river in southeastern Virginia flowing between Norfolk and Portsmouth into Hampton Roads
El Libertador|a mountain in the Andes in Argentina (22,047 feet high)
El Muerto|a mountain peak in the Andes on the border between Argentina and Chile (21,457 feet high)
English Channel|an arm of the Atlantic Ocean that forms a channel between France and Britain
Epsilon Aurigae|the largest known star
Eridanus|a constellation in the southern hemisphere near Fornax and Cetus
Euphrates|a river in southwestern Asia; flows into the Persian Gulf; was important in the development of several great civilizations in ancient Mesopotamia
Eurasia|the land mass formed by the continents of Europe and Asia
Europa|the 4th largest of Jupiter's satellites; covered with a smooth shell of frozen water
Europe|the 2nd smallest continent (actually a vast peninsula of Eurasia); the British use `Europe' to refer to all of the continent except the British Isles
Everest|a mountain in the central Himalayas on the border of Tibet and Nepal; the highest mountain peak in the world (29,028 feet high)
Everglades|a large subtropical swamp in southern Florida that is noted for its wildlife
Eyre|a shallow salt lake in south central Australia about 35 feet below sea level; the largest lake in the country and the lowest point on the continent
Eyre Peninsula|a peninsula of southern Australia
Fingal's Cave|a large cave with basaltic pillars on Staffa island in Scotland
Firth of Clyde|a firth on the southwestern coast of Scotland emptying into the North Channel
Firth of Forth|a large firth on the east coast of Scotland and the estuary of the Forth River; location of Edinburgh
Flint|a river in western Georgia that flows generally south to join the Chattahoochee River at the Florida border where they form the Apalachicola River
Fornax|a faint constellation in the southern hemisphere near Cetus and Phoenix
Forth|a river in southern Scotland that flows eastward to the Firth of Forth
Fountain of Youth|a fountain described in folk tales as able to make people young again; "Ponce de Leon discovered Florida while searching for the Fountain of Youth"
Fox River|a river in Wisconsin that flows into Lake Michigan
Galan|a mountain peak in the Andes in Argentina (21,654 feet high)
Galilean satellite|one of the four satellites of Jupiter that were discovered by Galileo
Galveston Bay|an arm of the Gulf of Mexico in Texas to the south of Houston
Galway Bay|a bay of the North Atlantic on the west coast of Ireland
Ganges|an Asian river; rises in the Himalayas and flows east into the Bay of Bengal; a sacred river of the Hindus
Gan Jiang|a river in southeastern China that flows generally north into the Chang Jiang to the north of Nanchang
Ganymede|the largest of Jupiter's satellites
Garonne|a river that rises in the Pyrenees and flows northwest to the Bay of Biscay
Gasherbrum|a mountain in northern Kashmir (26,470 feet high)
Gemini|a zodiacal constellation in the northern hemisphere between Taurus and Cancer on the ecliptic
Gila|a river that rises in western New Mexico and flows westward through southern Arizona to become a tributary of the Colorado River
Golden Gate|a strait in western California that connects the San Francisco Bay with the Pacific Ocean; discovered in 1579 by Sir Francis Drake
Gondwanaland|a hypothetical continent that (according to plate tectonic theory) broke up later into India and Australia and Africa and South America and Antarctica
Gosainthan|a mountain in the Himalayas in Tibet (26,290 feet high)
Grand Canyon|the enormous gorge of the Colorado River in northern Arizona
Grand River|a river in southern Michigan that flows northwest to empty into Lake Michigan
Grand Teton|a mountain peak in northwestern Wyoming; the highest peak in the Teton Range (13,766 feet high)
Great Attractor|a massive grouping of galaxies in the direction of Centaurus and Hydra whose gravitational attraction is believed to cause deviations in the paths of other galaxies
Great Australian Bight|a wide bay of the Indian Ocean in southern Australia; notorious for storms
Great Bear|a constellation outside the zodiac that rotates around the North Star
Great Barrier Reef|the largest coral reef in the world; in the Coral Sea off the northeastern coast of Australia
Great Dividing Range|a mountain range running along the eastern coast of Australia
Great Lakes|a group of five large, interconnected lakes in central North America
Great Plains|a vast prairie region extending from Alberta and Saskatchewan and Manitoba in Canada south through the west central United States into Texas; formerly inhabited by Native Americans
Great Rift Valley|( geology) a depression in southwestern Asia and eastern Africa; extends from the valley of the Jordan River to Mozambique; marked by geological faults
Great Salt Lake|a shallow body of salt water in northwestern Utah
Great Slave Lake|a lake in the Northwest Territories in northwestern Canada; drained by the Mackenzie River
Great Smoky Mountains|part of the Appalachians between North Carolina and Tennessee
Green|a river that rises in western Wyoming and flows southward through Utah to become a tributary of the Colorado River
Greenland Sea|part of the Arctic Ocean to the north of Iceland
Green Mountains|a range of the Appalachian Mountains that extends from south to north through Vermont
Grus|a small constellation in the southern hemisphere near Phoenix
Guadalupe Mountains|a mountain range in southern New Mexico and western Texas; the southern extension of the Sacramento Mountains
Guantanamo Bay|an inlet of the Caribbean Sea; a United States naval station was established on the bay in 1903
Gulf Coast|a seashore of the Gulf of Mexico
Gulf of Aden|arm of the Indian Ocean at the entrance to the Red Sea
Gulf of Alaska|a gulf of the Pacific Ocean between the Alaska Peninsula and the Alexander Archipelago
Gulf of Antalya|a gulf of the Mediterranean Sea in southwestern Turkey
Gulf of Aqaba|a northeastern arm of the Red Sea; between the Sinai Peninsula (Egypt) and Saudi Arabia
Gulf of Bothnia|a northern arm of the Baltic Sea; between Sweden and Finland
Gulf of California|a gulf to the west of the mainland of Mexico
Gulf of Campeche|a part of the Gulf of Mexico to the west of Yucatan
Gulf of Carpentaria|a wide shallow inlet of the Arafura Sea in northern Australia
Gulf of Corinth|inlet of the Ionian Sea between central Greece and the Peloponnesus
Gulf of Finland|an eastern arm of the Baltic Sea; between Finland and Estonia
Gulf of Guinea|a gulf off the southwest coast of Africa
Gulf of Martaban|an arm of the Andaman Sea off southern Myanmar
Gulf of Mexico|an arm of the Atlantic to the south of the United States and to the east of Mexico
Gulf of Ob|an inlet of the Kara Sea in western Siberia
Gulf of Oman|an arm of the Arabian Sea connecting it with the Persian Gulf
Gulf of Riga|an inlet of the Baltic Sea between Latvia and Estonia
Gulf of Saint Lawrence|an arm of the northwest Atlantic Ocean off the southeastern coast of Canada
Gulf of Sidra|wide inlet of the Mediterranean Sea on the north coast of Libya
Gulf of Suez|a northwestern arm of the Red Sea linked to the Mediterranean by the Suez Canal
Gulf of Tehuantepec|an arm of the Pacific in southern Mexico
Gulf of Thailand|an arm of the South China Sea between Indochina and the Malay Peninsula
Gulf of Venice|an arm of the Adriatic Sea
Hampton Roads|a channel in southeastern Virginia through which the Elizabeth River and the James River flow into Chesapeake Bay
Handies Peak|a mountain peak in the San Juan Mountains in southwestern Colorado (14,048 feet high)
Hangzhou Bay|a bay formed by an inlet of the East China Sea
Hercules|a large constellation in the northern hemisphere between Lyra and Corona Borealis
Himalayas|a mountain range extending 1500 miles on the border between India and Tibet; this range contains the world's highest mountain
Hindu Kush|a mountain range extending to the west of the Himalayas
Hook of Holland|a cape on the southwestern coast of the Netherlands near Rotterdam
Housatonic|a river that rises in western Massachusetts and flows south through Connecticut to empty into Long Island Sound
Huang He|a major river of Asia in northern China; flows generally eastward into the Yellow Sea; carries large quantities of yellow silt to its delta
Huascaran|a mountain in the Andes in Peru (22,205 feet high)
Hubbard|a mountain peak in southeastern Alaska that is part of the Coast Range (14,950 feet high)
Hudson|a New York river; flows southward into New York Bay; explored by Henry Hudson early in the 17th century
Hudson Bay|an inland sea in northern Canada
Humber|an estuary in central northeastern England formed by the Ouse River and the Trent River
Hydra|a long faint constellation in the southern hemisphere near the equator stretching between Virgo and Cancer
Hydrus|a constellation in the southern hemisphere near the south celestial pole
Iguazu|a large waterfall on the border between Argentina and Brazil
IJssel|a river in the central Netherlands flowing north to the IJsselmeer
IJsselmeer|a shallow lake in northwestern Netherlands created in 1932 by building a dam across the entrance to the Zuider Zee
Illampu|a mountain peak in the Andes in Bolivia (20,870 feet high)
Illimani|a mountain peak in the Andes in Bolivia (21,201 feet high)
Illinois River|a river in Illinois that flows southwest to the Mississippi River
Indian Ocean|the 3rd largest ocean; bounded by Africa on the west, Asia on the north, Australia on the east and merging with the Antarctic Ocean to the south
Indigirka|a river in far eastern Siberia that flows generally northward to the Arctic Ocean
Indus|an Asian river that rises in Tibet and flows through northern India and then southwest through Kashmir and Pakistan to the Arabian Sea; "the valley of the Indus was the site of an early civilization"
Indus|a faint constellation in the southern hemisphere near Telescopium and Tucana
Inland Passage|a naturally protected waterway from Seattle to Skagway in southeastern Alaska
Inland Sea|an arm of the Pacific Ocean in southern Japan; surrounded by the islands of Honshu and Shikoku and Kyushu and linked to the Sea of Japan by a narrow channel; the chief port is Hiroshima
Io|the closest of Jupiter's moons; has active volcanoes
Ionian Sea|an arm of the Mediterranean Sea between western Greece and southern Italy
Irish Sea|an arm of the North Atlantic between Great Britain and Ireland
Irrawaddy|the main river of Myanmar rising in the north and flowing south through the length of Burma to empty into the Andaman Sea
Irtish|an Asian river that rises in the Altai Mountains in northern China and flows generally northwest to become a tributary of the Ob River
Isere|a river in southeastern France; a tributary of the Rhone
Isthmus of Corinth|a narrow isthmus between the Gulf of Corinth and the Saronic Gulf; a canal crosses the isthmus so that navigation is possible between the gulfs
Isthmus of Kra|a narrow isthmus linking the Malay Peninsula to the Asian mainland
Isthmus of Panama|the isthmus that connects Central America and South America; was formerly called the Isthmus of Darien; "Balboa crossed the Isthmus of Darien"
Isthmus of Suez|the isthmus in northeastern Egypt that connects Africa and Asia
Isthmus of Tehuantepec|the narrowest part of southern Mexico is an isthmus between the Bay of Campeche on the north coast and the Gulf of Tehuantepec on the south coast
James|a river that rises in North Dakota and flows southward across South Dakota to the Missouri
James|a river in Virginia that flows east into Chesapeake Bay at Hampton Roads
James Bay|the southern extension of Hudson Bay in Canada between western Quebec and northeastern Ontario
Japan Trench|a depression in the floor of the Pacific Ocean to the northeast of Japan that reaches depths of 30,000 feet
Jebel Musa|a promontory in northern Morocco opposite the Rock of Gibraltar; one of the Pillars of Hercules
Jordan|a river in Palestine that empties into the Dead Sea; John the Baptist baptized Jesus in the Jordan
Jovian planet|any of the four outermost planets in the solar system; much larger than Earth and gaseous in nature (like Jupiter)
J particle|a neutral meson with a large mass
Jupiter|the largest planet and the 5th from the sun; has many satellites and is one of the brightest objects in the night sky
K"|a mountain peak in the Karakoram Range in northern Kashmir; the 2nd highest peak in the world (28,250 feet high)
Kamet|a mountain in the Himalayas in northern India (25,450 feet high)
Kanawha|a tributary of the Ohio River in West Virginia
Kanchenjunga|a mountain the Himalayas on the border between Nepal and Tibet (28,208 feet high)
Kansas|a river in northeastern Kansas; flows eastward to become a tributary of the Missouri River
Karakoram|a mountain range in northern Kashmir; an extension of the Hindu Kush; contains the 2nd highest peak
Kara Sea|part of the Arctic Ocean to the north of Siberia and to the east of the Barents Sea; icebound most of the year
Karelian Isthmus|the isthmus between the Gulf of Finland and Lake Ladoga that connects Finland and Russia
Kasai|a river of southwestern Africa that rises in central Angola and flows east and then north (forming part of the border between Angola and Congo) and continuing northwest through Congo to empty into the Congo River on the border between Congo and Republic of the Congo
Kattegatt|a strait of the North Sea between Jutland and Sweden; connects with the North Sea through the Skagerrak
Keuka Lake|a glacial lake in central New York; one of the Finger Lakes
Khyber Pass|a mountain pass of great strategic and commercial value in the Hindu Kush on the border between northern Pakistan and western Afghanistan; a route by which invaders entered India
Kilimanjaro|the highest peak in Africa; located in northeastern Tanzania; 19,340 feet high
Kissimmee|a river of central Florida that flows southward to Lake Okeechobee
Kivu|a lake in the mountains of central Africa between Congo and Rwanda
Klamath|a river flowing southwest from Oregon through northern California to the Pacific Ocean
Kodiak|an island off southern Alaska in the Gulf of Alaska; site of the first European settlement in the area which was founded by the Russians in 1784
Korea Bay|an inlet of the Yellow Sea between the Liaodong Peninsula in China and western Korea
Korean Strait|a strait between Korea and Japan; connects the East China Sea and the Sea of Japan
Kuiper belt|a disk-shaped region of minor planets outside the orbit of Neptune
Kuiper belt object|any of many minor planets in the Kuiper belt outside the orbit of Neptune at the edge of the solar system
Kunlun|a mountain range in western China that extends eastward from the Indian border for 1000 miles
Kura|a river in western Asia; rises in northeast Turkey and flows to the Caspian Sea
Labrador-Ungava Peninsula|a peninsular region of eastern Canada between Hudson Bay and the Labrador Sea; contains most of Quebec and the mainland part of Newfoundland and Labrador
Labrador Sea|an arm of the northern Atlantic between Labrador and southern Greenland
Lake Albert|a shallow lake on the border between Uganda and Congo in the Great Rift Valley
Lake Aral|a lake to the east of the Caspian Sea lying between Kazakhstan and Uzbekistan
Lake Chad|a lake in north central Africa; fed by the Shari river
Lake Champlain|a lake in northeastern New York, northwestern Vermont and southern Quebec; site of many battles in the French and Indian War and in the American Revolution and in the War of 1812
Lake Edward|a lake in the Great Rift Valley between Congo and Uganda
Lake Erie|the 4th largest of the Great Lakes; it is linked to the Hudson River by the New York State Barge Canal
Lake Geneva|a lake between southwestern Switzerland and France that is crossed from east to west by the Rhone
Lake Huron|the 2nd largest of the Great Lakes
Lake Ilmen|a lake in northwestern Russia; drains through the Volkhov River into Lake Ladoga
Lake Ladoga|a lake in northwestern Russia to the north of St. Petersburg; the largest lake in Europe; drains through the Neva River into the Gulf of Finland
Lake Michigan|the 3rd largest of the Great Lakes; the largest freshwater lake entirely within the United States borders
Lake Nasser|lake in Egypt formed by dams built on the Nile River at Aswan
Lake Nyasa|a long lake in southeastern Africa between Tanzania, Mozambique, and Malawi
Lake Onega|lake in northwestern Russia near the border with Finland; second largest lake in Europe
Lake Ontario|the smallest of the Great Lakes
Lake St. Clair|a lake between Ontario and Michigan; connected with Lake Huron and Lake Erie
Lake Superior|the largest freshwater lake in the world; the deepest of the Great Lakes
Lake Tana|a lake in northern Ethiopia; the largest lake in Ethiopia and the source of the Blue Nile
Lake Tanganyika|the longest lake in the world in central Africa between Tanzania and Congo in the Great Rift Valley
Lake Urmia|a shallow saline lake in northwestern Iran between Tabriz and the western border of Turkey
Lake Vanern|a lake in southwestern Sweden; the largest lake in Sweden
Lake Victoria|the largest lake in Africa and the 2nd largest fresh water lake in the world; a headwaters reservoir for the Nile River
Laptev Sea|part of the Arctic Ocean to the north of Siberia (between the Taimyr Peninsula and the New Siberian Islands) that is icebound most of the year
Large Magellanic Cloud|the larger of the two Magellanic Clouds visible from the southern hemisphere
Lascaux|a cave in southwestern France that contains Paleolithic paintings
Laudo|a mountain peak in the Andes in Argentina (20,997 feet high)
Laurasia|a hypothetical continent that (according to plate tectonic theory) broke up later into North America and Europe and Asia
Lehigh River|a river in eastern Pennsylvania that flows southeast into the Delaware River
Lena|a Russian river in Siberia; flows northward into the Laptev Sea
Leo|a zodiacal constellation in northern hemisphere between Cancer and Virgo
Lepus|a constellation in the southern hemisphere near Orion and Columba
Lethe|(Greek mythology) a river in Hades; the souls of the dead had to drink from it, which made them forget all they had done and suffered when they were alive
Lhotse|a mountain in the central Himalayas on the border of Tibet and Nepal (27,890 feet high)
Liaodong Peninsula|a peninsula in northeastern China that extends into the Yellow Sea, between Bo Hai and Korea Bay
Libra|a small faint zodiacal constellation in the southern hemisphere; between Virgo and Scorpius
Ligurian Sea|an arm of the Mediterranean between northwest Italy and Corsica
Limpopo|an African river; flows into the Indian Ocean
Little Bear|a constellation outside the zodiac that rotates around the North Star
Little Bighorn|a river that flows from northern Wyoming into the Bighorn River in southern Montana; site of Custer's Last Stand
Little Dipper|a cluster of seven stars in Ursa Minor; at the end of the dipper's handle is Polaris
Little Missouri|a river that rises in northeastern Wyoming and flows through Montana and South Dakota to join the Missouri River in North Dakota
Little Sioux River|a river that rises in southwestern Minnesota and flows southwestward to the Missouri River in western Iowa
Little Wabash|a river in eastern Illinois that flows southeastward to the Wabash River
Llano Estacado|a large semiarid plateau forming the southern part of the Great Plains
Llullaillaco|a mountain in the Andes on the border between Argentina and Chile (22,057 feet high)
Loch Achray|a lake in central Scotland
Loch Linnhe|an inlet of the Atlantic Ocean on the western coast of Scotland
Loch Ness|a lake in the Scottish highlands; the largest body of fresh water in Great Britain
Logan|a mountain peak in the St. Elias Range in the southwestern Yukon Territory in Canada (19,850 feet high)
Loire|the longest French river; rises in the Massif Central and flows north and west to the Atlantic Ocean
Loire Valley|the valley of the Loire River where many French wines originated
Long Island Sound|a sound between Long Island and Connecticut
Lower California|a mountainous peninsula on northwest Mexico
Lower Peninsula|the part of Michigan between Lake Michigan and Lake Huron
Lupus|a constellation in the southern hemisphere near Centaurus
Lyra|a small constellation in the northern hemisphere near Cygnus and Draco; contains the star Vega
Mackenzie|a Canadian river; flows into the Beaufort Sea
Madeira|a Brazilian river; tributary of the Amazon River
Magdalena|a river that rises in the Andes mountains in southwestern Colombia and flows generally northward to empty into the Caribbean Sea at Barranquilla
Magellanic Cloud|either of two small galaxies orbiting the Milky Way; visible near the south celestial pole
Makalu|a mountain in the Himalayas in Nepal (27,790 feet high)
Marmara|an inland sea in northwestern Turkey; linked to the Black Sea by the Bosporus and linked to the Aegean by the Dardanelles
Mars|a small reddish planet that is the 4th from the sun and is periodically visible to the naked eye; minerals rich in iron cover its surface and are responsible for its characteristic color; "Mars has two satellites"
Massachusetts Bay|an inlet of the Atlantic Ocean off of eastern Massachusetts extending from Cape Ann on the north to Cape Cod on the south
Massif Central|a mountainous plateau in southern France that covers almost one sixth of the country
Matterhorn|a mountain in the Alps on the border between Switzerland and Italy (14,780 feet high); noted for its distinctive shape
McKinley|a mountain in south central Alaska; the highest peak in North America (20,300 feet high)
Mediterranean|the largest inland sea; between Europe and Africa and Asia
Mekong|an Asian river; flows through a large delta in southern Vietnam into the South China Sea
Menai Strait|a strait in northern Wales between Anglesey Island and the mainland
Mendenhall Glacier|a glacier of the Piedmont type near Juneau in Alaska
Mensa|a faint constellation in the polar region of the southern hemisphere and containing part of the Large Magellanic Cloud
Mercedario|a mountain in the Andes in Argentina (22,210 feet high)
Mercury|the smallest planet and the nearest to the sun
Merrimack|a river that rises in south central New Hampshire and flows through Concord and Manchester into Massachusetts and empties into the Atlantic Ocean
Mesabi Range|a range of hills in northeastern Minnesota where rich iron ore deposits were discovered in 1887
Meuse|a European river; flows into the North Sea
Microscopium|a faint constellation in the southern hemisphere near Sagittarius and Capricornus
Mid-Atlantic Ridge|a very long narrow elevation on the ocean floor that runs all the way from Iceland in the North Atlantic to Bouvet Island in the South Atlantic
Milk|a river that rises in the Rockies in northwestern Montana and flows eastward to become a tributary of the Missouri River
Milky Way|the galaxy containing the solar system; consists of millions of stars that can be seen as a diffuse band of light stretching across the night sky
Minamata Bay|a bay on the west coast of Kyushu; in the 1950s industrial wastes caused mercury poisoning among the Japanese people who ate fish from Minamata Bay
Mississippi|a major North American river and the chief river of the United States; rises in northern Minnesota and flows southward into the Gulf of Mexico
Missouri|the longest river in the United States; arises in Montana and flows southeastward to become a tributary of the Mississippi at Saint Louis; "The Missouri and Mississippi Rivers together form the third longest river in the world"
Mobile|a river in southwestern Alabama; flows into Mobile Bay
Mobile Bay|a bay of the Gulf of Mexico; fed by the Mobile River
Mohawk River|a river of central New York that flows southeastward to the Hudson River
Mohorovicic discontinuity|the boundary between the Earth's crust and the underlying mantle; "the Mohorovicic discontinuity averages 5 miles down under oceans and 20 miles down under continents"
Monongahela|a river that rises in northern West Virginia and flows north into Pennsylvania where it joins the Allegheny River at Pittsburgh to form the Ohio River
Mont Blanc|the highest mountain peak in the Alps; on the border between France and Italy to the south of Geneva (15,781 feet high)
Monterey Bay|an inlet of the Pacific Ocean in western California
Moon|the natural satellite of the Earth; "the average distance to the Moon is 384,400 kilometers"; "men first stepped on the moon in 1969"
Moray Firth|an inlet of the North Sea on the northeast coast of Scotland
Moreau River|a river that rises in western South Dakota and flows eastward to the Missouri River
Moreton Bay|an arm of the Tasman Sea forming a bay to the east of Brisbane
Mount Bartle Frere|the highest mountain peak in Queensland, Australia
Mount Carmel|a mountain range in northwestern Israel near the Mediterranean coast; "according to the Old Testament, Elijah defeated the priests of Baal at Mount Carmel"
Mount Elbert|the highest peak in the Rocky Mountains in central Colorado (14,431 feet high)
Mozambique Channel|an arm of the Indian Ocean between Madagascar and southeastern Africa
Murray|a southeast Australian river; flows westward and then south into the Indian Ocean at Adelaide
Murrumbidgee|a river of southeastern Australia; flows westward into the Murray River
Musca|a small constellation in the polar region of the southern hemisphere near the Southern Cross and Chamaeleon
Muztag|a highest mountain peak in the Kunlun Shan in China; near the Indian border (23,891 feet high)
Nacimiento|a mountain peak in the Andes in Argentina (21,302 feet high)
Namoi|a river in southeastern Australia that flows generally northwest to join the Darling River
Nan|a river of western Thailand flowing southward to join the Ping River to form the Chao Phraya
Nanda Devi|a mountain in the Himalayas in northern India (25,660 feet high)
Nanga Parbat|a mountain in the Himalayas in Kashmir (26,660 feet high)
Nan Ling|a mountain range in southeastern China running generally east to west
Nares Deep|a depression in the floor of the Atlantic Ocean to the north of Haiti and Puerto Rico
Narragansett Bay|a deep inlet of the Atlantic Ocean in Rhode Island
Neckar|a river in Germany; rises in the Black Forest and flows north into the Rhine
Neosho|a river that rises in eastern Kansas and flows eastward into Oklahoma to become a tributary of the Arkansas River
Neptune|a giant planet with a ring of ice particles; the 8th planet from the sun is the most remote of the gas giants; "the existence of Neptune was predicted from perturbations in the orbit of Uranus and it was then identified in 1846"
Neva|a river in northwestern Russia flowing generally west into the Gulf of Finland
New River|a river in the southeastern United States that flows northward from North Carolina to West Virginia where it empties into the Kanawha River
New York Bay|a bay of the North Atlantic; fed by the Hudson River
Niagara|a river flowing from Lake Erie into Lake Ontario; forms boundary between Ontario and New York
Niagara|waterfall in Canada is the Horseshoe Falls; in the United States it is the American Falls
Niger|an African river; flows into the South Atlantic
Nile|the world's longest river (4150 miles); flows northward through eastern Africa into the Mediterranean; the Nile River valley in Egypt was the site of the world's first great civilization
Niobrara|a tributary of the Missouri River
Norma|a small constellation in the southern hemisphere near Lupus and Ara in the Milky Way
North America|a continent (the third largest) in the western hemisphere connected to South America by the Isthmus of Panama
North Atlantic|that part of the Atlantic Ocean to the north of the equator
North Channel|a strait between Northern Ireland and Scotland that connects the Atlantic Ocean and the Irish Sea
Northern Cross|a cluster of 5 bright stars forming a cross in the constellation Cygnus
North Pacific|that part of the Pacific Ocean to the north of the equator
North Peak|19,370 feet high
North Platte|a river that rises in northern Colorado and flows northward into Wyoming and then eastward and southeastward through Nebraska where it joins the South Platte to form the Platte River
North Sea|an arm of the North Atlantic between the British Isles and Scandinavia; oil was discovered under the North Sea in 1970
Norwegian Sea|the part of the Atlantic that lies off the Norwegian coast to the north of the North Sea
Nuptse|a mountain in the central Himalayas on the border of Tibet and Nepal (25,726 feet high)
Ob|a major river of western Siberia; flows generally northward and westward to the Gulf of Ob and the Kara Sea
Octans|the constellation that includes the southern celestial pole
Oder|a European river; flows into the Baltic Sea
Ohio|a river that is formed in western Pennsylvania and flows westward to become a tributary of the Mississippi River
Ojos del Salado|a mountain in the Andes on the border between Argentina and Chile (22,572 feet high)
Okeechobee|a lake in southeast Florida to the north of the Everglades
Okefenokee Swamp|a large swampy area of northeast Florida and southeast Georgia
Old Faithful|a geyser in Yellowstone National Park that erupts for about 4 minutes about every 65 minutes
Olduvai Gorge|a gorge in northeastern Tanzania where anthropologists have found some of the earliest human remains
Olympus|a mountain peak in northeast Greece near the Aegean coast; believed by ancient Greeks to be the dwelling place of the gods (9,570 feet high)
Omega Centauri|a global cluster in the constellation Centaurus
Ophiuchus|a large constellation in the equatorial region between Hercules and Scorpius
Orange|a river in South Africa that flows generally westward to the Atlantic Ocean
Orinoco|a South American river 1,500 miles long; flows into the South Atlantic
Orion|a constellation on the equator to the east of Taurus; contains Betelgeuse and Rigel
Osage|a river in Missouri that is a tributary of the Missouri River
Osaka Bay|a bay of the western Pacific in southern Honshu
Outaouais|a river in southeastern Canada that flows along the boundary between Quebec and Ontario to the Saint Lawrence River near Montreal
Ouachita|a river that rises in western Arkansas and flows southeast into eastern Louisiana to become a tributary of the Red River
Ouse|a river in northeastern England that flows generally southeastward to join the Trent River and form the Humber
Ozarks|an area of low mountains in northwestern Arkansas and southeastern Missouri and northeastern Oklahoma
Pacific|the largest ocean in the world
Pacific Coast|a coast of the Pacific Ocean
Pallas|a large asteroid; the second asteroid to be discovered
Pamir Mountains|a mountain range in central Asia that is centered in Tajikistan but extends into Kyrgyzstan and Afghanistan and Pakistan and western China
Pangaea|(plate tectonics) a hypothetical continent including all the landmass of the earth prior to the Triassic period when it split into Laurasia and Gondwanaland
Para|an estuary in northern Brazil into which the Tocantins River flows
Parana|a South American river; tributary of Rio de la Plata
Parnaiba|a river in northeastern Brazil that flows generally northward to the Atlantic Ocean
Parnassus|(Greek mythology) a mountain in central Greece where (according to Greek mythology) the Muses lived; known as the mythological home of music and poetry; "Liakoura is the modern name of Mount Parnassus"
Paulo Afonso|a major waterfall in northeastern Brazil
Pavo|a small constellation near the South Pole between Tucana and Ara
Pearl River|a river in Mississippi that flows southward to the Gulf of Mexico
Pecos|a tributary of the Rio Grande that flows southeastward from New Mexico through western Texas
Pee Dee|a river that flows through central North Carolina and northeastern South Carolina to the Atlantic Ocean
Pegasus|a constellation in the northern hemisphere near Andromeda and Pisces
Penobscot|a river in central Maine flowing into Penobscot Bay
Penobscot Bay|an inlet of the Atlantic in eastern Maine
Perejil|a small uninhabited Mediterranean islet claimed by both Morocco and Spain
Perseus|a conspicuous constellation in the northern hemisphere; between Auriga and Cassiopeia and crossed by the Milky Way
Persian Gulf|a shallow arm of the Arabian Sea between Iran and the Arabian peninsula; the Persian Gulf oil fields are among the most productive in the world
Phobos|the larger of the two satellites of Mars
Phoenix|a constellation in the southern hemisphere near Tucana and Sculptor
Pictor|a constellation in the southern hemisphere near Dorado and Columba
Piedmont glacier|a type of glaciation characteristic of Alaska; large valley glaciers meet to form an almost stagnant sheet of ice
Pike's Peak|a mountain peak in the Rockies in central Colorado (14,109 feet high)
Pillars of Hercules|the two promontories at the eastern end of the Strait of Gibraltar; according to legend they were formed by Hercules
Ping|a river in western Thailand; a major tributary of the Chao Phraya
Pisces|a large faint zodiacal constellation; between Aquarius and Aries
Pissis|a mountain in the Andes in Argentina (22,241 feet high)
Platte|a river in Nebraska that flows eastward to become a tributary of the Missouri River
Pleiades|a star cluster in the constellation Taurus
Pluto|a large asteroid that was once thought to be the farthest known planet from the sun; it has an elliptical orbit; "Pluto was discovered by Clyde Tombaugh in 1930"
Po|a European river; flows into the Adriatic Sea
Pobeda Peak|a mountain peak in the Tien Shan mountains in northern India (24,406 feet high)
Polaris|the brightest star in Ursa Minor; at the end of the handle of the Little Dipper; the northern axis of the earth points toward it
Pollux|the brightest star in Gemini; close to Castor
Potomac|a river in the east central United States; rises in West Virginia in the Appalachian Mountains and flows eastward, forming the boundary between Maryland and Virginia, to the Chesapeake Bay
Poyang|a lake in central China that is connected to the Chang Jiang by a canal
Procyon|the brightest star in Canis Minor
Proxima|the nearest star to the sun; distance: 4.3 light years
Prudhoe Bay|a bay on the northern coast of Alaska where oil was discovered in 1968
Puget Sound|an inlet of the North Pacific in northwestern Washington State
Puppis|a constellation in the southern hemisphere between Vela and Canis Major that shaped like the stern of a boat
Purus|a Brazilian river; tributary of the Amazon River
Pyrenees|a chain of mountains between France and Spain
Pyxis|a constellation in the southern hemisphere near Puppis and Antlia
Quaoar|a planetoid discovered in 2002
Queen Charlotte Sound|an inlet of the Pacific Ocean off the coast of British Columbia
Rakaposhi|a mountain peak in the Karakoram Range in northern Kashmir (25,560 feet high)
Rainier|a mountain peak in central Washington; highest peak in the Cascade Range; (14,410 feet high)
Rappahannock|a river that flows across eastern Virginia into the Tidewater region
Red|a tributary of the Mississippi River that flows eastward from Texas along the southern boundary of Oklahoma and through Louisiana
Red Sea|a long arm of the Indian Ocean between northeast Africa and Arabia; linked to the Mediterranean at the north end by the Suez Canal
Regulus|the brightest star in Leo
Republican|a tributary of the Kansas River that flows from eastern Colorado eastward through Nebraska and Kansas
Reticulum|a small constellation in the southern hemisphere near Dorado and Hydrus
Rhine|a major European river carrying more traffic than any other river in the world; flows into the North Sea
Rhodope Mountains|a mountain range in the Balkan peninsula in southeastern Europe; extends along the border between Greece and Bulgaria
Rhone|a major French river; flows into the Mediterranean near Marseilles; "the valley of the Rhone is famous for its vineyards"
Rigel|the brightest star in Orion
Rio de la Plata|an estuary between Argentina and Uruguay
Rio Grande|a North American river; boundary between the United States and Mexico; flows into Gulf of Mexico
Rockies|the chief mountain range of western North America; extends from British Columbia to northern New Mexico; forms the continental divide
Ross Sea|an arm of the southern Pacific Ocean in Antarctica
Ruhr|a tributary of the Rhine
Rushmore|a mountain in the Black Hills of South Dakota; the likenesses of Washington and Jefferson and Lincoln and Roosevelt are carved on it
Russell's body|an inclusion body found in plasma cells in cases of cancer
Russian River|a river in northern California
Saale|a river that rises in central Germany and flows north to join the Elbe River
Sabine|a river in eastern Texas that flows south into the Gulf of Mexico
Sacramento Mountains|mountain range in New Mexico to the east of the Rio Grande
Sacramento River|a river in northern California rising near Mount Shasta and flowing south to the San Francisco Bay
Sagitta|a small constellation in the northern hemisphere between Cygnus and Aquila and crossed by the Milky Way
Sagittarius|a large zodiacal constellation in the southern hemisphere; between Scorpius and Capricornus
Saint Francis|a tributary of the Mississippi River that rises in Missouri and flows southeastward through Arkansas
Saint John|a river that rises in Maine and flows northeastward through New Brunswick to empty into the Bay of Fundy
Saint Johns|a river in northeastern Florida that flows northward to Jacksonville and then eastward to empty into the Atlantic Ocean
Saint Lawrence|a North American river; flows into the Gulf of Saint Lawrence and the North Atlantic
Sajama|a mountain peak in the Andes in Bolivia (21,391 feet high)
Salmon|a tributary of the Snake River in Idaho
Salton Sea|a saltwater lake in southeastern California
Sambre|a river in western Europe that rises in northern France and flows generally east into Belgium where it joins the Meuse at Namur
San Andreas Fault|a major geological fault in California; runs from San Diego to San Francisco; the source of serious earthquakes
San Diego Bay|a bay of the Pacific in southern California
San Fernando Valley|a fertile valley in southern California to the north of Los Angeles; includes many residential communities
San Francisco Bay|a bay of the Pacific in western California
San Joaquin River|a river in central California that rises in the Sierra Nevada and flows northwest to form a large delta with the Sacramento River
San Joaquin Valley|a vast valley in central California known for its rich farmland
San Juan Hill|a hill in eastern Cuba (near Santiago de Cuba) that was captured during the Spanish-American War; "Theodore Roosevelt and his Rough Riders became famous for their charge up San Juan Hill"
San Juan Mountains|a mountain range in southwestern Colorado that is part of the Rocky Mountains
Sao Francisco|a river in eastern Brazil flowing into the Atlantic Ocean
Saone|a river in eastern France; rises in Lorraine and flows south to become the chief tributary of the Rhone
Sargasso Sea|a vast area of the North Atlantic from the West Indies to the Azores that is dense with gulfweed
Saronic Gulf|a gulf of the Aegean on the southeastern coast of Greece
Saturn|a giant planet that is surrounded by three planar concentric rings of ice particles; the 6th planet from the sun
Savannah|a river in South Carolina that flows southeast to the Atlantic
Sayan Mountains|a range of mountains in southern Siberia to the west of Lake Baikal; contain important mineral deposits
Scheldt|a river that rises in France and flows northeast across Belgium and empties into the North Sea
Scorpius|a large zodiacal constellation between Libra and Sagittarius
Sculptor|a faint constellation in the southern hemisphere near Phoenix and Cetus
Sea of Azov|a bay of the Black Sea between Russia and the Ukraine
Sea of Japan|an arm of the Pacific bordered by Japan, Korea, North Korea, and Russia
Sea of Okhotsk|an arm of the Pacific to the east of Asia
Sedna|a planetoid of rock and ice about three-quarters the size of Pluto discovered in 2003; the most distant object known to orbit around the sun
Seine|a French river that flows through the heart of Paris and then northward into the English Channel
Selkirk Mountains|a range of the Rocky Mountains in southeastern British Columbia
Seneca Lake|a glacial lake in central New York; the largest of the Finger Lakes
Serpens|a constellation in the equatorial region of the northern hemisphere near Ophiuchus and Corona Borealis
Sete Quedas|a great waterfall on the border between Brazil and Paraguay
Severn|a river in England and Wales flowing into the Bristol Channel; the longest river in Great Britain
Severn|a river in Ontario that flows northeast into Hudson Bay
Seyhan|a Turkish river flowing south southwest into the Mediterranean
Shari|an African river that flows northwest into Lake Chad
Shasta|a volcanic mountain peak in the Cascade Range in northern California (14,162 feet high)
Shenandoah River|a river of northern Virginia that empties into the Potomac at Harpers Ferry
Sherman|a peak in the Rocky Mountains in central Colorado (14,036 feet high)
Shenandoah Valley|a large valley between the Allegheny Mountains and the Blue Ridge Mountains in northern Virginia; site of numerous battles during the American Civil War
Sherwood Forest|an ancient forest in central England; formerly a royal hunting ground; said to be the home of Robin Hood and his merry band
Sierra Madre Occidental|a mountain range in northwestern Mexico that runs south from Arizona parallel to the Pacific coastline
Sierra Madre Oriental|a mountain range in northeastern Mexico the runs parallel to the coastline of the Gulf of Mexico
Sierra Nevada|a mountain range in eastern California; contains Mount Whitney
Sierra Nevada|a mountain range in southern Spain along the Mediterranean coast to the east of Granada
Sinai|a mountain peak in the southern Sinai Peninsula (7,500 feet high); it is believed to be the peak on which Moses received the Ten Commandments
Sirius|the brightest star in the sky; in Canis Major
Skagens Odde|a cape on the northernmost tip of Jutland between the Skagerrak and the Kattegatt
Skagerrak|a broad strait of the North Sea between Jutland and Norway
Small Magellanic Cloud|the smaller of the two Magellanic Clouds visible from the southern hemisphere
Snake|a tributary of the Columbia River that rises in Wyoming and flows westward; discovered in 1805 by the Lewis and Clark Expedition
Solent|a strait of the English Channel between the coast of Hampshire and the Isle of Wight
Solway Firth|a large firth on the west coast of Britain between England and Scotland
South America|a continent in the western hemisphere connected to North America by the Isthmus of Panama
South Atlantic|that part of the Atlantic Ocean to the south of the equator
South China Sea|a tropical arm of the Pacific Ocean near southeastern Asia subject to frequent typhoons
Southern Cross|a small conspicuous constellation in the southern hemisphere in the Milky Way near Centaurus
South Pacific|that part of the Pacific Ocean to the south of the equator
South Platte|a tributary of the Platte River
South Sea|any sea to the south of the equator (but especially the South Pacific)
South Sea Islands|any islands in the southern or southwestern of central parts of the Pacific Ocean
Spica|the brightest star in Virgo
St. Elias Range|a range of mountains between Alaska and the Yukon territory
Sterope|one of the stars in the star cluster Pleiades
Strait of Georgia|the strait separating Vancouver Island from the Canadian mainland
Strait of Gibraltar|the strait between Spain and Africa
Strait of Hormuz|a strategically important strait linking the Persian Gulf and the Gulf of Oman
Strait of Magellan|the strait separating South America from Tierra del Fuego and other islands to the south of the continent; discovered by Ferdinand Magellan in 1520; an important route around South America before the Panama Canal was built
Strait of Messina|the strait separating Sicily from the tip of Italy
Strait of Dover|the strait between the English Channel and the North Sea; shortest distance between England and the European continent
Strait of Malacca|the strait between the Malay Peninsula and Sumatra; it connects the Pacific Ocean to the east with the Indian Ocean to the west and is an important shipping lane
Styx|(Greek mythology) a river in Hades across which Charon carried dead souls
Sun River|a river in western Montana that flows south and east to join the Missouri River
Suriname River|a river in Suriname that flows northward to the Atlantic
Susquehanna|a river in the northeastern United States that rises in New York and flows southward through Pennsylvania and Maryland into Chesapeake Bay
Taconic Mountains|a range of the Appalachian Mountains along the eastern border of New York with Connecticut, Massachusetts, and Vermont
Tagus|a European river; flows into the North Atlantic
Takakkaw|a waterfall in southeastern British Columbia; the highest waterfall in Canada (1250 feet high)
Tallapoosa|river that rises in northwestern Georgia and flows southwest through central Alabama to join the Coosa River near Montgomery and form the Alabama River
Tampa Bay|an arm of the Gulf of Mexico in west central Florida
Tasman Sea|an arm of the southern Pacific Ocean between southeastern Australia and New Zealand
Taurus|a zodiacal constellation in the northern hemisphere near Orion; between Aries and Gemini
Telescopium|a small constellation in the southern hemisphere near Ara
Tennessee|a river formed by the confluence of two other rivers near Knoxville; it follows a U-shaped course to become a tributary of the Ohio River in western Kentucky
Teton Range|a mountain range in northwest Wyoming; contains the Grand Teton
Thames|the longest river in England; flows eastward through London to the North Sea
Tiber|a river of central Italy; flows through Rome to the Tyrrhenian Sea
Tien Shan|a major mountain range of central Asia; extends 1,500 miles
Tigris|an Asian river; a tributary of the Euphrates River
Timor Sea|an arm of the eastern Indian Ocean between Timor and northern Australia
Tirich Mir|a mountain in the Hindu Kush in Pakistan (25,230 feet high)
Titan|the largest of the satellites of Saturn; has a hazy nitrogen atmosphere
Tocantins|a river in eastern Brazil that flows generally north to the Para River
Tombigbee|a river that rises in northeastern Mississippi and flows southward through western Alabama to join the Alabama River and form the Mobile River
Torres Strait|a strait between northeastern Australia and southern New Guinea that connects the Coral Sea with the Arafura Sea
Transylvanian Alps|a range of the southern Carpathian Mountains extending across central Romania
Trapezium|a multiple star in the constellation of Orion
Trent|a river in central England that flows generally northeastward to join with the Ouse River and form the Humber
Triangulum|a small northern constellation near Perseus between Andromeda and Aries
Triangulum Australe|a small bright constellation in the polar region of the southern hemisphere near Circinus and Apus
Trinity River|a river in eastern Texas that is formed near Dallas and flows generally southeastward to Galveston Bay
Triton|the largest moon of Neptune
Trondheim Fjord|a long narrow inlet of the Norwegian Sea
Tucana|a large faint constellation in the southern hemisphere containing most of the Small Magellanic Cloud
Tugela|a major waterfall in southern Africa; has more than one leap
Tunguska|a river that arises to the north of Lake Baikal and flows north and west to the Yenisei River
Tunguska|a river in Siberia that flows northwest to become a tributary of the Yenisei River
Tupungato|a mountain in the Andes on the border between Argentina and Chile (22,310 feet high)
Twin|a waterfall in the Snake River in southern Idaho
Tyrolean Alps|a popular tourist area in the Tyrol
Tyne|a river in northern England that flows east to the North Sea
Tyrrhenian Sea|an arm of the Mediterranean between Italy and the islands of Corsica and Sardinia and Sicily
Ulugh Muztagh|a mountain in the Kunlun range in China (25,340 feet high)
Uncompahgre Peak|the highest peak in the San Juan Mountains of southwestern Colorado (14,309 feet high)
United States waters|territorial waters included within a distance of 12 nautical miles of the coasts of the United States and its territories; "ships operating in United States waters must adhere to United States laws and regulations"
Upper Peninsula|the peninsula between Lake Superior and Lake Michigan that forms the northwestern part of Michigan
Urals|a mountain range in western Russia extending from the Arctic to the Caspian Sea; forms part of the traditional boundary between Europe and Asia
Uranus|a giant planet with a ring of ice particles; the 7th planet from the sun has a blue-green color and many satellites; "Uranus was discovered by William Herschel in 1781"
Urubupunga|a waterfall in the Parana river in Brazil
Uruguay River|a South American river that arises in southern Brazil and flows south to the Rio de la Plata; the northern section forms the boundary between Argentina and Brazil and the southern section forms the boundary between Argentina and Uruguay
Vega|the brightest star in the constellation Lyra
Vela|a constellation in the southern hemisphere between Carina and Pyxis; "because of its configuration Vela is sometimes called `the Sails'"
Venus|the second nearest planet to the sun; it is peculiar in that its rotation is slow and retrograde (in the opposite sense of the Earth and all other planets except Uranus); it is visible from Earth as an early `morning star' or an `evening star'; "before it was known that they were the same object the evening star was called Venus and the morning star was called Lucifer"
Vesta|the brightest asteroid but the fourth to be discovered
Vetluga|a river in central Russia; flows generally southward into the Volga
Victoria|a waterfall in the Zambezi River on the border between Zimbabwe and Zambia; diminishes seasonally
Virgo|a large zodiacal constellation on the equator; between Leo and Libra
Vistula|a European river; flows into the Baltic Sea
Volans|a small constellation in the polar region of the southern hemisphere near Dorado and Carina
Volga|a Russian river; the longest river in Europe; flows into the Caspian Sea
Volkhov|a river in northwestern Russia flowing generally north into Lake Ladoga
Volta|a river in Ghana that flows south to the Bight of Benin
Vulpecula|a constellation in the northern hemisphere near Cygnus and Sagitta
Wabash|a tributary of the Ohio River that rises in western Ohio and flows southwestward across Indiana
Weddell Sea|an arm of the south Atlantic in Antarctica to the east of the Antarctic Peninsula
Weisshorn|a mountain in the Alps in Switzerland (14,804 feet high)
Weser|a river in northwestern Germany that flows northward to the North Sea near Bremerhaven
Wheeler Peak|a mountain peak in northeastern New Mexico in the Rocky Mountains
White|a tributary of the Mississippi River that flows southeastward through northern Arkansas and southern Missouri
White Nile|a headstream of the Nile; joins the Blue Nile at Khartoum to form the Nile
White Sea|a large inlet of the Barents Sea in the northwestern part of European Russia
Whitney|the highest peak in the Sierra Nevada range in California (14,494 feet high)
Wight|an isle and county of southern England in the English Channel
Wilderness|a wooded region in northeastern Virginia near Spotsylvania where bloody but inconclusive battles were fought in the American Civil War
Willamette|a river in western Oregon that flows north into the Columbia River near Portland
Wilson|a peak in the San Juan mountains of Colorado (14,246 feet high)
Windward Passage|a channel between eastern Cuba and western Haiti that connects the Atlantic Ocean with the Caribbean Sea
Winnipeg|a lake in southern Canada in Manitoba
Wisconsin|a tributary of the Mississippi River in Wisconsin
Yalu|river in eastern Asia; rises in North Korea and flows southwest to Korea Bay (forming part of the border between North Korea and China)
Chang Jiang|the longest river of Asia; flows eastward from Tibet into the East China Sea near Shanghai
Yazoo|a river that rises in west central Mississippi and flows southwest to empty into the Mississippi River above Vicksburg
Yellow Sea|part of the Pacific off the east coast of Asia
Yellowstone|a tributary of the Missouri River that flows through the Yellowstone National Park
Yenisei|a Russian river in Siberia; rises in mountains near the Mongolian border and flows generally northward into the Kara Sea
Yerupaja|a mountain peak in the Andes in Peru (21,709 feet high)
Yosemite|a series of waterfalls in Yosemite National Park in California; is reduced to a trickle for part of each year
Yukon|a North American river that flows westward from the Yukon Territory through central Alaska to the Bering Sea
Zambezi|an African river; flows into the Indian Ocean
Zhu Jiang|a river in southeast China that flows into the South China Sea
Zuider Zee|a former inlet of the North Sea in the northern coast of the Netherlands; sealed off from the sea in 1932 by a dam that created the IJsselmeer
